P	P	P	P	H	P	M	P	P	P	P	P	H	P	M	P	P	P	P	P	H	P	M	P
P	P	P	H	H	P	M	P	P	P	P	H	H	P	M	P	P	P	P	H	H	P	M	P
P	F	P	P	P	P	M	P	P	F	P	P	P	P	M	P	P	F	P	P	P	P	M	P
P	F	F	P	P	P	P	P	P	F	F	P	P	P	P	P	P	F	F	P	P	P	P	P
P	P	P	P	P	P	P	P	P	P	P	P	P	P	P	P	P	P	P	P	P	P	P	P
P	F	F	P	P	M	M	P	R	F	F	P	P	M	M	P	P	F	F	P	P	M	M	P
P	P	P	F	P	P	P	P	R	P	P	F	P	P	P	P	P	P	P	F	P	P	P	P
P	P	P	P	R	R	R	R	R	R	R	R	R	R	R	R	R	P	P	P	P	P	P	P
P	P	P	P	H	P	M	P	R	P	P	P	H	P	M	P	R	R	R	P	H	P	M	P
P	P	W	H	H	P	M	P	R	P	P	H	H	P	M	P	R	P	P	H	H	P	M	P
P	F	W	P	P	P	M	P	R	F	P	P	P	P	M	P	R	F	P	P	R	P	M	P
P	F	W	W	P	P	P	P	R	F	F	P	P	P	P	P	R	F	F	P	R	P	P	P
P	S	S	S	S	P	P	P	R	P	P	P	P	P	P	P	R	P	P	P	R	P	P	P
P	S	E	S	S	M	M	P	R	F	F	P	P	M	M	P	R	F	F	P	R	M	M	P
P	S	S	E	S	P	P	P	R	P	P	F	P	P	P	P	R	P	P	F	R	P	P	P
P	S	S	S	S	R	R	R	R	R	P	P	P	R	R	R	R	P	P	P	R	P	P	P
P	P	P	F	P	P	M	P	P	R	P	F	R	R	M	M	P	P	H	F	R	H	H	P
P	P	P	P	P	P	P	M	P	R	R	R	R	P	M	P	P	H	H	P	R	P	H	H
P	P	P	F	P	P	P	P	M	P	P	F	P	P	P	P	P	H	H	F	R	P	H	P
P	P	P	P	P	P	P	P	P	P	P	P	P	P	P	P	R	R	R	R	R	P	P	P
